|  ||  ||  |    ----
|  ||  ||  |    |  |
|  ||  ||  |    |  |
|  ||  ||  |--- |  |
|  ||  ||  ||  ||  |
|  ||  ||  ||  ||  |
|  ||  ||  ||      |
|  ||      ||  
|  ||  ||      ||  |
|  ||  ||  ||  ||  |
|  ||  ||  ||  ||  |
|  ||  ||  ||  ||  |
|  ||  ||  |----|  |
|      ||  |    |  |
|  ||  ||  |    |  |
------------    |  |
                |  |
                выход
